x00000000
xxx000000
00x00xxx0
00x00x000
00000x000
x00xxx000
000000000
000000000